111111111
100000C01
100000001
100000E01
1P0000001
111111111
