1111111111111111111111111111111111
1E0P0000P000000C00000C00E000000001
1010010100100000101001000000010101
101001001010101000100100P000010101
1P000P000C00C000000000000P000000C1
1111111111111111111111111111111111
